0 0 4 4 4 4 0 0 0 0 0 0 0 0 0 0 0 0 0 0 0 0 4 4 0 0 
0 0 4 4 4 4 0 0 0 0 0 0 0 0 0 0 0 0 0 0 0 0 4 4 0 0 
4 4 4 4 0 0 0 0 0 0 1 1 1 1 0 0 0 0 0 0 0 0 0 0 4 4 
4 4 4 4 0 0 0 0 1 1 1 1 1 1 1 1 1 1 0 0 0 0 0 0 4 4 
4 4 0 0 0 0 0 1 1 1 1 1 1 1 1 1 1 1 1 1 0 0 0 0 2 2 
4 4 0 0 0 0 0 1 1 1 1 1 1 1 1 1 1 1 1 1 1 1 0 0 0 0 
2 2 0 0 0 0 1 1 1 1 1 1 1 1 1 1 1 1 1 1 1 1 1 0 0 0 
0 0 0 0 0 0 1 1 1 1 1 1 1 1 1 1 1 1 1 1 1 1 1 0 0 0 
0 0 0 0 0 1 1 1 0 0 0 0 0 0 1 1 1 1 1 1 0 0 1 0 0 0 
0 0 0 0 0 1 0 0 0 0 0 0 0 0 0 0 1 1 1 1 0 0 1 0 0 0 
5 5 0 0 0 1 0 0 2 0 0 0 2 0 0 0 1 1 1 0 0 0 0 0 0 0 
5 5 0 0 0 1 0 0 2 0 0 0 2 0 0 0 1 1 1 0 0 0 0 0 0 0 
0 0 0 0 1 1 0 0 0 0 0 0 0 0 0 0 1 1 1 0 0 0 0 0 5 5 
0 0 0 0 1 1 0 0 1 1 1 1 0 0 0 0 1 1 1 0 0 0 0 0 5 5 
0 0 0 0 1 1 1 1 1 1 1 1 1 1 1 1 1 1 1 1 0 0 0 0 0 0 
0 0 0 0 1 1 1 1 1 1 1 1 1 1 1 1 1 1 1 1 0 0 0 0 0 0 
0 0 0 1 1 1 1 1 1 1 1 1 1 1 1 1 1 1 1 1 1 0 0 0 0 0 
0 0 0 1 1 1 1 1 1 1 1 1 1 1 1 1 1 1 1 1 1 0 0 0 0 0 
0 0 1 1 1 1 1 1 1 1 1 1 1 1 1 1 1 1 1 1 1 1 0 0 0 0 
0 0 0 0 0 0 1 1 1 1 1 1 1 1 1 1 1 1 0 0 0 0 0 0 0 0 
0 0 1 1 1 1 0 0 1 1 1 1 1 1 1 1 0 0 1 1 1 1 0 0 4 4 
0 0 1 1 1 1 1 1 0 0 1 1 1 1 0 0 1 1 1 1 1 1 0 0 4 4 
4 4 0 0 1 1 1 1 0 0 0 0 0 0 0 0 1 1 1 1 0 0 4 4 4 4 
4 4 0 0 0 0 0 0 0 0 0 1 1 1 1 0 0 0 0 0 0 0 4 4 4 4 
2 2 4 4 0 0 0 0 0 0 0 1 5 5 1 0 0 0 0 0 4 4 4 4 2 2 
2 2 4 4 0 0 0 0 0 0 0 1 5 5 1 0 0 0 0 0 4 4 4 4 2 2 
